- 88 - LM.C
- Burst The Gravity - ALTIMA
- Baby It's You - JUNE
- Be as One - W-inds
- ?
- Bokura no Goal - T-Pistonz+KMC
- ?
- Boukoku Kakusei Carthasis - ALI project
- Boys Be Ambitious!! - HI-FI CAMP
- Breakthrough - GOING UNDER GROUND
- Brightdown - Nami Tamaki
- Boys & Girls - LM.C
- Blood Teller - Faylan
- BACCHIKOI!! - DEV PARADE
- ?
- Blood Circulator - AKFG
- Blue Bird - Ikimonogakari
- Broken Youth - NICO touches the wall
- By My Side - Hemenway
- Boku ni dekiru koto - How merry marry
- Brand New World - D-51
- Believe - Folder5
- Bon Voyage - BON-BON BLANCO
- CORE PRIDE - UVERworld
- Cagayake Girls - Houkago Tea Time
- Cagayake Girls (with Azusa) - Houkago Tea Time
- Candy Line - Hitomi Takahashi
- Chain - BACK-ON
- Change - miwa
- Chase the world - May'n
- Climber - Galileo Galilei
- Colors - FLOW
- ?
- ?
- Can Do - GRANRODEO
- Catal Rhythm - OLDCODEX
- Cascade - Unlimits
- CLOSER - Joe Inoue
- ?
- Chikyuugi - Yumi Matsuzawa
- Crossing Field - LiSA
- ?
- DONTEN - DOES
- D-Tecnolife - UVERworld
- Datte Atashi no Hero - LiSA
- Deepest Memories - Yuki Kajiura
- Destiny Girl - Minato
- Don't say lazy - Houkago Tea Time
- Don't think, feel! - Idoling!!
- Drawing Days - Splay
- Dive to World - Cherry Blossom
- Dead End - Faylan
- Dame Dame Da - Shiori Tomita
- Distance - Long Shot Party
- Diver - NICO Touches The Wall
- Diver (Instrumental) - NICO Touches The Wall
- Dreamin' On - Da Ice
- Don't mind lay lay boy - Etsuko Nishio
- Driver's High - L'arc en ciel
- Edge - Yuki Kajiura
- Egao no Mahou - MAGIC PARTY
- Emerald Green - See-Saw
- ?
- Evidence - Daisy x Daisy
- Echo Again - Splay

